1,1,1,1,1,1,1,1,1,1,1,1,1,1,1,1,1,1,1,1,1,1,1,1,1,1
1,0,0,0,0,0,0,0,0,1,1,1,1,1,1,1,1,1,1,1,1,1,1,1,1,1
1,0,0,0,1,1,0,0,0,0,0,3,1,1,0,0,1,0,0,0,1,1,0,0,1,1
1,0,0,0,1,1,0,0,7,7,0,0,1,1,0,0,1,0,0,0,1,1,0,0,1,1
1,0,1,1,1,1,1,1,0,0,0,0,1,1,0,0,0,0,0,4,1,1,0,0,0,1
1,0,1,1,1,1,1,1,0,0,0,0,0,0,0,7,0,0,0,0,0,0,0,0,0,1
1,0,0,0,1,1,0,0,0,0,0,0,0,0,0,0,1,0,0,0,4,0,0,0,1,1
1,0,0,0,1,1,0,0,0,0,0,0,0,0,0,4,1,0,0,0,0,0,0,0,1,1
1,0,0,0,0,0,4,0,0,0,1,1,1,1,1,1,1,0,1,1,1,1,1,1,1,1
1,0,0,0,0,0,1,4,0,0,0,0,0,0,0,0,0,0,0,0,0,0,0,0,0,1
1,0,0,0,0,0,0,0,0,0,0,0,7,0,0,0,0,0,1,1,1,1,1,1,0,1
1,0,0,0,0,0,0,0,0,1,1,1,1,1,1,0,0,0,0,0,4,0,0,8,0,1
1,0,0,1,0,0,0,0,0,0,0,0,0,0,1,0,0,0,0,1,0,0,1,0,0,1
1,4,0,1,1,1,1,0,0,0,0,0,0,0,1,0,0,4,0,1,0,0,1,0,0,1
1,0,0,0,0,0,0,0,0,4,0,7,1,1,1,0,0,0,0,1,0,0,1,0,0,1
1,0,0,0,0,1,0,6,0,0,0,0,1,5,0,0,0,0,0,1,0,0,1,0,0,1
1,0,0,0,0,1,1,2,1,0,0,0,1,0,0,0,0,0,0,0,0,0,0,0,0,1
1,1,1,1,1,1,1,1,1,1,1,1,1,1,1,1,1,1,1,1,1,1,1,1,1,1
