1,1,1,1,1,1,1,1,1,1,1,1,1,1,1,1,1,1,1,1,1,1,1,1,1,1,1,1,1,1,1,1,1,1
1,1,1,1,1,1,1,1,1,0,0,0,0,0,0,0,1,1,1,1,1,1,1,1,1,1,1,1,1,1,1,1,1,1
1,0,0,0,0,0,0,0,0,0,0,0,0,0,0,0,1,0,0,0,0,0,0,0,1,0,0,0,0,0,0,1,1,1
1,0,1,1,1,1,1,0,0,0,0,0,1,1,1,1,1,0,1,1,1,1,1,0,1,0,0,0,0,0,0,1,1,1
1,0,0,0,0,0,1,4,0,0,0,0,0,0,0,0,0,0,1,0,0,0,1,0,1,0,0,1,1,0,0,0,1,1
1,0,0,0,0,0,1,0,0,0,0,0,0,0,0,0,0,0,1,0,4,5,1,0,1,0,0,0,1,0,7,0,0,1
1,4,0,0,0,0,1,0,0,1,0,0,4,0,0,7,0,0,0,0,0,0,0,0,1,0,0,0,0,0,0,0,0,1
1,0,0,0,0,0,1,0,0,0,0,0,0,1,0,0,0,0,0,0,0,0,0,0,0,0,0,0,7,0,0,0,1,1
1,0,0,0,0,0,1,0,0,4,0,0,0,1,0,0,1,0,0,0,0,0,0,0,0,1,1,0,0,0,1,1,1,1
1,0,0,0,0,1,0,0,0,1,1,1,1,1,1,1,1,0,0,0,0,0,0,0,0,0,0,0,0,0,0,0,0,1
1,1,1,1,1,1,0,0,0,0,0,3,1,1,0,0,1,8,1,1,1,1,1,1,0,4,0,0,0,0,0,0,0,1
1,0,0,0,0,1,0,0,0,0,0,0,1,1,0,0,1,0,0,0,0,0,7,0,0,0,0,1,1,1,1,1,1,1
1,0,0,0,0,1,0,0,0,0,0,0,1,1,0,0,0,0,0,7,1,1,0,0,0,0,0,1,1,1,1,1,1,1
1,0,0,0,0,1,1,1,1,0,0,0,0,0,0,0,0,0,0,0,1,1,0,0,0,0,0,0,0,0,0,0,0,1
1,1,1,0,0,0,0,0,0,0,0,0,0,0,0,0,1,0,0,0,0,0,0,0,0,0,0,0,0,0,0,0,0,1
1,4,1,1,1,1,1,1,1,0,0,4,0,0,0,0,1,0,1,1,1,1,1,1,0,0,0,0,0,0,6,0,0,1
1,0,0,0,4,0,0,0,0,7,1,1,1,1,1,1,1,0,0,0,0,0,0,0,0,1,1,1,1,1,2,1,1,1
1,1,1,1,1,1,1,1,1,1,1,1,1,1,1,1,1,1,1,1,1,1,1,1,1,1,1,1,1,1,1,1,1,1
